Set:       Haikemono collection
Copyright: © Jordi Doménech
Email:     jd2006@abelmartin.com
Homepage:  http://www.abelmartin.com/rj/rj.html

This is an extract from "Haikemono.sok"

32
##############################
#                            #
# $  $  $$  $$ $  $ $  $ $ $ #
# $$  $  $ $  $$ $    $ $ $  #
# $  $ $$$$ $ $   $ $ $$  $  #
#  $ $ .....##########. $  $ #
# $ $ $##..*.....#....*   $  #
#    $ #..#......*.*... $$ $ #
# $ $  #..#..########.# $ $  #
# $   $#..#..#........#    $ #
#  $ $ #*.#...*....*..# $ $$ #
# $   $#..#.*##.#..#.*#      #
# $$$  #.*#....+#*.#..# $ $  #
#   $  #.....*.....#.*#$$$ $ #
#  $ $ #...######..#*.#  $   #
# $   $#..*.....#..#..#$  $$ #
#  $ $ #.......**..#..# $    #
#   $$ .*..*.#.....#..#  $ $ #
# $ $  .##########*#*.# $$$  #
#     $   $  $   $ $  $    $ #
# $$ $  $   $  $    $$  $$$  #
# $  $ $ $ $$ $ $$$ $  $  $$ #
#                            #
##############################
Title: What's up
Author: Jordi Doménech
solution:
uurrrurrruululldLLLLLulDDDlddddllluurDlddrdRRRdrrurDllllluuurrurrdLrrrrruuuurrddddDrddlUUUUUULLLdDDDDDLLulDlluRRlllluuLuluUUUruurRRRRRdrrrurrrdrrddrrddrrruuuuuuulDuuLuullllllllllllllldDDDDuuulDDuuuulllddrRDDDDDDDDDDDldRRRRRllluuruuuRuuuuluuuulDuulDDDDDDDDDDDDDlUUUUUruuuuuulluRurDDDDDDDDDDDlddrruLdlUUUUruuuuuuullDRurDDDDDDDDDldddRRRRlluuLuuuuuuuululldRRurDDDDDDDDDDlUUUruuuuuulluuulDllddRRRRurDDDDDDDDldddRRRluuLuuuuuuuulluullDRRllluuRRRRurDDDDDDDDDDDDDlUUruuuuuuulluRurDDDDDDDDDldddRRuuLdlUruuuuuuuulllulldRRRRurDDDDDDDDDrdLuuuuuuuuullllluuululldRRRRRRllllllddRRRRRRuuRurDDDDDDDDDDDDlDRuuuuuuuuulluRurDDDDDDDDDuuuuuuRRRRlddddDlddlLuuuuuuuullllluuullDRRRRRlllllldRRRRRRuRurDDDDDDDDDDDrDLddrUluuuuuuuuuulluRurDDDDDDDDDDDDrddRurrrrrrruuuuuurrruuurrddrrddrrdDrdddddddddlllluLdlllluuluUULrUUUUUUluurrdLulDDDDDDDrddddrddlUUUUUUUUUUUluurrdLrrruuulLLLLLLLulDDDDuuurrrrrrrrrrruLrrrDLLLLLLLLLLLLulDDlddddRRdLLuuurDldRluuuurDDDDuuuuurrrrrrrrrrrrruuulDrrrrddLLLLLLLLLLLLLLLulDDDDDuuuurrrrrrrrrrrrruurrDrdLLLLLLLLLLLLLLLulDDDDuuuruRdrrrrrrrrrddrUdrrULuLLLLLLLLLLLLulluuurrdLulDDldRDDDDDDuuuuuuuuulDDllllllulldRRRRRRRRurDDDDDDDuuuuuuuuuurrrrrdddlLLLulDDDDDDDuuuuuuuuurrDLulDDDDDDDDuuuuurrrrruuLLDLLulDDDDDDuuuurruruLLrrrrdLLrdLLLulDDDDuullllllllddddrruruUluRRRurDDDDDDDDDDuuuuuuuuullldddlUlllUluRRRRRRRurDDDDDDDDDuuuuuuuulllddllUluRRRRRurDDDDDDDDuuuuuuulllddlddlUUUluRRRRRurDDDDDDDuuuuuulllddlUluRRRRurDDDDDDuuuuulllllllldddRldddRuUURlUUluRRRRRRRurDDDDDuuuullllddddlUUddddrUUUUlUluRRRRRurDDDDuuulllddlUluRRRRurDDDuulllldddddrUUUUluRRRurDruuuurDDDDDRDDDuuuRlluurrruLrrrururrrrrrrdDlDDrDrdLLLLLLLLLLLLulDDurrrrrrrrrruurDrdLLLLLLLLLLLullullDRRRDrrrrrrrrrrruuuurDuuulDDDDDrdLLLLLLLLLLLrrrrrrrrrruuuuulldRDDDrdLLLLLLLLLrrrrrrrruuuuurDDrDrrrddLLLLLLLLLLLLrrrrrrruuululluRRurDDDDDrdLLLLLLLrrrrrruuululldRRurDDDLLLrrrrdLLLLLLrrrrruuullluuLLLLLLLulDDDDldRuurruLulDDDurrrrrrRRRRurDrDrDLLLLrrrrrdLLLLLLLrrrrrddrUruLLLLLLrrrrddddrUUrddrUUUruLLLLLLLrrrddrUruLLLLddLLLLLrDLuLDDurrDDDDDrdddddlluRdrUUUUUUUUUluurrdLLrrrddddrdddddlLdlUUUULLLLLLLrrrrrrrUUUUUluurrdLulDDDDDDrdddddddlUdlluRRdrUUUUUUUUUUUluurrdLulDLulDrrDDDDrdddddlldRdrUUUUUUUUUUddddddddrrUUUUUUUUUruLLLrdLuLDDDrdddddddlllldRRllldRldllluurRRRdRRRdrUUUUUUUUUUUluuLrrrdLdddddddddlldRdrUUUUUUUULLLLrrrrUUUruLLDDDrdddddddlllldRRRdrUUUUUUUULLLrrrUUluurrdLulDDDrdddddddlllldlllllulluuRRRULdlldddRRRRRRRRllluRRRRRdrUUUUUUULLrrUUluurrdLulDDDrddddLLLLLLLLdlllddrrRRRRRRRRdrUUUUUUUUUluurrdLulDDrddLdDrdLLLLLLLrrrrrrrdddllldRRdrUUUUUUUUUUluurrdLLdDDDDrdLLLLLLrrrrrrdddllllldddllURRRRRRdrUUUUUUUUUUUluurrdLulDDDDDDrdLLLLLrrrrrdddlllllllldRRRRRRlllllllldRRRRRRRRRdrUUUUUUUUUUUluurrdLulDDDDDDrddddlldRdrUUUUULLLLrrrrUUUUUluurrdLulDDDDDDrddddllllllllllldldRRRRRRRRRRRdrUUUUUULLLrrrUUUUUluurrdLulDDDDDDrddddlllllllllllulldRRRRRRRRRRRRdrUUUUUUUUUluLrurrdLLrrrruuurrrrrruLLrruuLLruuLLulDDDlDulllluLLLLLLulDDllllllddddddddrUUUUUUluRRRurDllllllldddddRldRRUUUUUluRRRRRRurDlllldddddddlUUUUUUluRRRRRllllllllddddddddrrURlUUUUUUluRRRRRRllddddddddlUUUUUUldddddDllUUUUUUUluRRRRRRlddlUluRRdddddddddDDDDldRRRRRRRRRRRRdrUUUULLrrUUUUUluurrdLulDDDDDDrddddllllllllllllllluRlulDldRRRRRRRRRRRRRRRRdrUUUULrUUUUUluurrdLulDDDDDDrddddlllllllllllluuuulldRlDRRRRRlllllDldRRRRRRRRRRRRRRdrUUUUUUUUUluurrdLulDDDDDrdddddlllllllllllllluRRluuurDuuulDDDDRlllluRlluRRRDDDldRRRRRRRRRRRRRRdrUUUUUUUUUluurrdLulDDDDrddddddlllllllllllluuRRlluuulDDuuulDDDDRlDRlldRRRRRRRRRRRRRRdrUUUUUUUUUluurrdLulDDDrdddddddllllllllllllluuRRllluuuulDDDldRRRRDldRRRRRRRRRRRRdrUUUUUUUUUluurrdLulDDrddddddddlllllllllllllldRRRRRRRRRRRRRdrUUUUUUUUUUluurrdLulDrdddddddddllllllllllllllddRRRRRRRRRRRRRdrUUUUUUUUUUUddddddddrruuuuuuuuulLdddddddddlllllllllllllllllddRRRRRRRRRRRRRRRRdrUUUUUUUUUUUUruLddddddddddllllllllllllllddllURRRRRRRRRRRRRlllllllllllllluRRRRRRRRRRRRRRRRdrUUUUUUUUUUdddddddddllldRRdrUUUUUUUUUUddddddddrdddrruLLdlUUUUUUUUUUdddddddrddrrdrruLLLUdrruLLUddLdlUUUUUUUUUddddddrrdLdlUUUUUUUdddddrrrdrruLLLLdlUUUUUddddrrUUUUUUUUUruLdddrUldddrUddddddrrddrrdrrULLLLLrrrrrruuLLLLLLLdlUUUUUUUUUrULddddddddddddrUrrrrrrUruLLLLLLLLLdlUUUUdddrrrrdLLLdlUUUUddrrrrrrrrrruuulldDrdLLLLLLrrddrrrUruLLLLLrddrrULLLLUdLUUUUUUUUUUdddddddddrrrrdrruLLLLLdlUUUUUUUUdrUlUddddddddrrrrrrrruuuuuuuuuLLLrrUUruLLLLLuLLddDuuurrdLulDDurrddddrUUUruLLLulDrrrruLLLuurDuurDrrrruuLLLLrDDDLrDrdLLLLrruLruuuuLulDDDrDDrdLrrrrddddddldDDDDrdLLLLLLUUUUUUddddddrruurDlddrruLLLdlUUUUUUdddddrrrrruuulululDDDDrdLLdlUUUUUddddrrrrruuurDDruuuLLuurDDDDuuuuuulllldDDDDDDrdLLdlUUUUdddrrrrrdrruLLLLLLdlUUUddrrrrruurDrdLLLLLLdlUUdrruuuuuuuurrrDDDDLLulDDDDrdLLdlUdlUdLdlUUUdrrrrruuuurrrDDDLrrdLLLLLLLUUUUUUUdddddddrrruurDrdLLLLdlUUUUUUUddddddrrruuuurDDurDDrdLLLLLdlUUUUUUdddddrrruurDrdLLLLdlUUUUUddddrrrrrruuuuuuulLDDDDuuuuulDDDDDDDrdLLLdlUUUUdddrrruuurDDrdLLLLdlUUUddrrrrrruuuuuuLDDDDDrdLLLLLdlUUdrrruuuuuuurDDDDDDrdLLLLdlULdlU
