00 = The smallest legal level (empty solution)
####
#@*#
####