
neighboring small 2-room corrals

#########
#       #
#.+.    #
# $     #
#   #   #
## $ $  #
#   ##  #
#########
