Move optimization 1

####    
#  #####
#@$#  .#
# $  .##
####  # 
   #### 

What move lower bound does this level have?!


  #######
  #     #
### $@$ #
#..   ###
#######