Pushes/Moves

###
#.###
#   #
# $ #
# @##
####

Why the pushes/moves optimizer mustn't mark a board position as visited immediately but first when it is taken out of the pushes queue.

Solution 11/3
luurrdLdlUU


Critical Points 1

#######
#     #
#  @$ #
# # ###
#     #
#  $  #
#     #
# .#  #
##.####
 ###

Solution 33/11/6/2/6
ddrdLulDDDuruuuuurrdLulDDDrdLulDD


Critical Points 2

########
#    ..#
#@$   ##
#     #
## $###
 #  #
 ####

Solution 24/10/4/2/4
drUluRRRRddlllddrUUUluRR


Critical Points 3

#####
#  .#
#  .##
# @  #
#  # ###
## $   #
 #  #$ #
 ##    #
  ######

Solution 37/14/7/2/7
rrddLdlUUUUluRddddrddrrUruLLLdlUUUluR


Critical Points 4

  ###
  #.#
###.#
#   #
#   ##
# @  #
#  # ###
## $   #
 #  #$ #
 ##    #
  ######

Solution 47/18/9/2/9
rrddLdlUUUUluRdrUUdddrddrrddlUruLLLdlUUUUluRdrU


Critical Points 5

     ####
    ##. ##
##### .  #
#   #  # #
# $ #  # #
# $  @   #
######  ##
     ####

Solution:

Solution 59/16/5/2/5
lluullddRRRRuruurrdddldlUUUUdddllluulDldRRRRuruurrdddldlUUU


Critical Points 6

#####
#   #######
# $ ##   .#
# $   @  .#
# $ ##   .#
#   #######
#####

Solution 62/25/8/3/8
lllddlluuRRRRRRRdrUllllllddlUluRRRRRurDldRRllullluulDldRRRRRRR


Active area restriction in optimizer

#################
#               #
#@$             #
#               #
#               #
#               #
#               #
#               #
#               #
#               #
#               #
#               #
#               #
#              .#
#################

Solution 88/72
RRRRRRRRRRRRurDDrdLLLLLLLLLLLLulDDDldRRRRRRRRRRRRurDDDDrdLLLLLLLLLLLLu
lDDldRRRRRRRRRRRRR