Level

##########
#     #@##
#     #$##
#     $  #
#        #
# ##    ##
#.##    ##
#.##    ##
##########


######  
#  @ ###
# $$ ..#
#    ###
#    #  
######


Pfadaktualisierungstest

####     
#  ######
#@$    .#
#   #####
##  #    
 #### 

Solution
urDldRdrUluRRRR


Optimizer test - End position level

######
# *@ #
#    #
######

Solution:
dlluRdrruL
