

Level

  #####   #   ######
  #   #   #   #    #
  #   #   #   #    #
  #.#############  #
  # #           ####
  ### ##  #  #  #
    # ## # # #  # .
    #     #  ## #
 ####  #        ####
    #  # ##   # #
### # ##  ## ## # #
# # #         # #
### #  ## #     # ##
    #   #  # #  # ##
 ####  ## @  ## #
 #  # # $ * .#  #
 #$ #   #       #  $
 ################
          #
          #
          #

SaveGame 6/0/0/0/0/5
rdrull
