>"YASGen 2", by Brian Damgaard
>
> ########
>##@$ .. #
># $#$ *.#
>#  $  *.#
># $  #.$#
>##  # . #
> #      #
> ########
>
>
>Solution/Moves (Built-in)
>DlddRluurDDuRRdLuluuRRDrRDrDuluurDlllullddrdrUlluurrRdrdLLLrruulDrrruL
>ddlLdlddrrruUrULLruurDllluRdrddddllluurUruullldlddRURRdLddrrruuuululll
>DlddRluururrrdrruLLrdddddllluUruRldlddrrruuUlldllluurDRRRuurrdLDDrUlll
>dlddrrrrUUlullllldRurDrurruulLDurrdddrddlllllUUruRRluurrdDlldllluRRdrU
>lluuRRRllldddddrUUluRRRlUdlluurRdR
>
>Solution/Pushes (Built-in)
>DlddRluurDDuRRdLuluuRRDrRDrDuluurDllluRlllddrdrUlluurrrdrdLLLrruulDrdL
>rruruLddlldlddrrruUrULuurDllluRllldlddRluurDRluurrrdrddddllluUrULdddrr
>ruuuulullldlddRluururrrdrruLLrdddddllluUruRldlddrrruuUlldllluurDRRRuur
>rdLDDrUlllldddrrrrUUluuulLDurrdddrddlllluuulldRurRuurrdddrddlllluUruRl
>uurrdDlldlluRRRluRldlluuRRRddldlddlUUluRRdrUUdlluurR
