dfgdfdafdsafaäkäafkäk
#d#
#fdsfd
sdsfdsafds
df
dasf
ds
fds
g
egre
dsf
dsa
ggdgdsölajölködslkdsköladölkjfsdaöfökdsjfldjsökfjdöflasdfdsa
ea
ssg
dasagdsga
adflfjdsajldsajfldsa
adjsfkasdjgödsaköjljg
e
asjdfödsajkdajökljölkdgse
asdgfdsafsadfasfsafadsf
lurd