Title 1

#####
#@$.#
#####


Title 2
######
#@$. #
######


test text1

Solution/Moves 1/1/1/1/1
R

test text2


Title 3
#####
#@$.#
#####


#50 (3)

#####
#@$.#
#####

