######
#    #
# @$.#
#    #
######

solution
urrdLulldRR


Level

#######
#     #
# @$ .#
#     #
#######

solution
RurrdLulldRR


#######
#     #
# $$  #
# ..  #
#     #
#  @  #
###  ##
  #### 

solution
uuruulDDDldRuuuulDDDrddrUruLulldldRRdrUUruLdLdlU


Best soution: 9 / 16

  ###   
  #.#   
### ####
#@$   .#
# # ####
#   #   
#  $#   
##  #   
 ####  

solution
dddrdrUUUUUdddlluuRRRR


Best soution: 18 / 92  

   ###     
  ## # ####
 ##  ###  #
##        #
#      #$ #
### $###  #
  #  #..  #
 ##@##.# ##
 # $    ## 
 #     ##  
 #######   

solution
uuuurrrrrrdddllldddlllluRRluurUluurrdLulDDDDuuuurrrrrDrddllldddlluRdrUUddlllluRRRdrUllluuuuurrrrrdDrdL


Sasquatch 11 171/26

  ####
###  ####
#   @   ##
# #. .#.###
# $$$ $$$ #
###.#.#.# #
 ##       #
  ####  ###
     ####

solution
rrrdDuullddddlluUUrurrrddLruulldlldddrruUUlldRurDllddrrrrrruuLLrrddlllllluuuruulDllddRRddrrrrrruulluulLrrddrrddlllllluulluurrurDrrrddDuuullllllddrrddrrrRuuuullddRluullllddrrddrrrruUrrddLruulllluullllddrrddrrrdrUlllluuURldddrrrrrruullllLulDuruulD


#######
#     #
# $$  #
# +.  #
#######

solution
luurDRurDrdL



###### 
#    # 
#@$  # 
## # # 
#  # ##
#  #  #
#     #
# . ###
#####  

solution
RRurDDDDrdLLdlluurD


Best solution: 29 / 4

#######
#     #
# ##$.#
# # @$#
# #.$.#
#     #
###  ##
  #### 

<solution>
lddrruLrUddlllluuuurrrDDlDRddlU


############
#          #
# @$       #
#  #  ##   #
#  # ###   #
#     $.   #
#   .      #
############

Solution/Moves 19/14
RRRRRurDDDDrdLLLLuR


#########
#    #@ #
#     * #
##.### ##
##$### # 
#  ### # 
#      # 
#  ##### 
####     

solution
rdLLLrrddddlllluUddrrrruuuullulldRRR


10 / 25

 ####
##  ######
# $   #. #
#  $@ .  #
#    #   #
##########


MasSasquatch 34

 #####  #####
 #   ####   #
## #$.*.$ # #
#   $.@.$   #
# # $.*.$# ##
#   ####   #
#####  #####

Title: MasSasquatch 34 68/22
Author: David W. Skinner


Sasquatch 01 134/30

   ###
  ## # ####
 ##  ###  #
## $      #
#   @$ #  #
### $###  #
  #  #..  #
 ## ##.# ##
 #      ##
 #     ##
 #######

Title: Sasquatch 01 134/30
Author: David W. Skinner


Sasquatch 02 55/16

 ## #####
## ## . #
# ## $. #
 ## $   #
## $@ ###
# $  ##
#.. ## ##
#   # ##
##### #

Title: Sasquatch 02 55/16
Author: David W. Skinner


Sasquatch 08 153/17

    #######
    #     ##
##### ###  ##
#       #  ##
#@$***. ##$ #
#  #    ## .#
##  ##  # $ #
 ##  ####.$.#
  ##        #
   ######  ##
        ####

Title: Sasquatch 08 153/17
Author: David W. Skinner


Sasquatch 09 152/40

#########
#. .    #
#.$. .  #
## ###@ #
 #  $  ##
 # $$ ##
 #  $ #
 #  ###
 ####

Title: Sasquatch 09 152/40
Author: David W. Skinner


Sasquatch 11 171/26

  ####
###  ####
#   @   ##
# #. .#.###
# $$$ $$$ #
###.#.#.# #
 ##       #
  ####  ###
     ####

Title: Sasquatch 11 171/26
Author: David W. Skinner


Sasquatch 13 217/46

   #######
 ###     ##
 #   ###  #
 #      # #
###$#@  # #
#   ##### #
#   #  *. #
##$$#  *.##
 #     *..#
 #### #...##
    # #$$$ #
    #   $  #
    #####  #
        ####

Title: Sasquatch 13 217/46
Author: David W. Skinner


Sasquatch 14 81/15

 #######
##     # 
#  *.$.#
#  *.#.###
# #$@$$  #
#   ## # #
######   #
     #####

Title: Sasquatch 14 81/15
Author: David W. Skinner


Sasquatch 15 179/36

   ####
   #@ #
  ##  ##
  # .$#####
  #$. #   #
###..$# # #
#  ..$  $ #
# $ $ # ###
##### # #
    #   #
    ###.#
      ###

Title: Sasquatch 15 179/36
Author: David W. Skinner



Tunnel 1 54 / 99

  #####
###   ###
#@  #.. #
# $$# $.#
#   #  .#
### #   #
  # ## ##
  # ## #
  # ## #
 ## ## #
 #  ## #
 # $   #
 #     #
 #######


Tunnel 2 12 / 20

  ###     
  #.######
### ##   #
#@$     .#
# # #    #
# # ######
#   #     
## $#     
 #  #     
 #### 


Tunnel 3 8 / 20

 #####     
 # $.#####
## ###   #
#@$     .#
# # #    #
# # ######
#   #     
## $#     
 # .#     
 ####  


Tunnel 4  7 / 14
       
  ########
### ##   #
#@$     .#
# # #    #
# # ######
#   #     
## $#     
 # .#     
 ####  